RoasterControl	KEYWORD1
TempControl	KEYWORD1
PIDController	KEYWORD1
DisplayInterface	KEYWORD1
ProfileManager	KEYWORD1

begin	KEYWORD2
update	KEYWORD2
startRoast	KEYWORD2
stopRoast	KEYWORD2
adjustFan	KEYWORD2
adjustHeat	KEYWORD2
toggleManualMode	KEYWORD2

IDLE	LITERAL1
CHARGING	LITERAL1
DRYING	LITERAL1
MAILLARD	LITERAL1
FIRST_CRACK	LITERAL1
DEVELOPMENT	LITERAL1
COOLING	LITERAL1
EMERGENCY_STOP	LITERAL1